   ##################################################
#                                                   #
#                            ^                      #
#     ####        ^                        ####     #
#        #                      ^          #        #
#        #                                 #        #
#        #                                 #        #
#        #        #################        #        #
#        #        #               #        #        #
#        #        |      $$$      #        #  ^     #
#        #        |      $$$      #        #        #
#        #        |      $$$      #        #        #
#        #        #              *#        #        #
#        #        #################        #      ^ #
#    ^   #                                 #        #
#        #                                 #        #
#        #         ^                       #        #
#     ####                        ^        ####     #
#   ^                                               #
#                                     ^             #
#####################################################

